? ? ? ? ? ? ? ?
? ? ? ? ? ? ? ?
? ? ? ? ? ? ? ?
? ? 1 ? ? ? ? ?
? 1 R 1 ? ? ? ?
? ? 1 ? ? ? ? ?
? ? ? ? ? ? ? ?
F F F F F F F F
